3111111111111111111111111111111111111111111111111111111111111111111111111111111111111111111111111111111111111111111111111111111111111111111111111111111111111111111111111111111111111111111111111113
3111111111111111111111111111111111111111111111111111111111111111111111111111111111111111111111111111111111111111111111111111100111101110011111110111111111111111111110011111111111111111111111111113
3111111111111111111111111111111111111111111111111111111111111111111111111111111111111111111111111100000000001000001100110000000001001100000011100110000011100111111110001111000111111111100111110113
3000000000000000000000000000000000000000000000000000000000000000000000000000000000000000000000000000000000000000000000000000000000000000000000000000000000000000000000000000000000000000000000000003
3000000000000000000000000000000000000000000000000000000000000000000000000000000000000000000000000000000000000000000000000000000000000000000000000000000000000000000000000000000000000000000000000003
3000000000000000000000000000000000000000000000000000000000000000000000000000000000000000000000000000000001111111110000000000000000000001111111111111000000000000000000111111111111111111111111111113
3000000000000000000000000000000000000000000000000000000000000000000000000000000000000000000000000000000000000000000000000000000000000111111111111110001111111111111111111110000000011111111111111113
3000000000000000000000000000000000000000000000000000000000000000000000000000000000000011111111111111111111111111111000001111000000001111111111111110000000000000000000000000000000011111111111111113
3000000000000000000000000000000000000000000000000000000000000000000000000000000000011111111100000000000000000000000000000000000001111111111111111100011111000000000000000001111111111111111100000003
3000000000000000000000000000000000000000000000000000000000000000000000001111111111111111111000000000000000000000000000000000000000000000000000000001111110000000000000000011111111111111111000000003
3000000000000000000000000111111111111000000000000000000000011111111111111111111111000000000000000000000001110001111111000000000001111110000000000000000000000000000000000111111111111111111000000003
3000000000000000000000001111111111111100000000001111111111111111111111111111110000000000000000000000000000000000000000000111111111110000000000001111111111110000000000001111111111111111100000000003
3111111111100011100111111111000000111111111111111111111111111111111111111111111111111111111111111111111111111111111111111111111111111111111111111111111111111111111111111111111111111000000001111113
3111111111110000000000000000000001111111111111000000000000000001111111111111111111111100000000000000000001111111111111111111111111111111000000000000000000000000000000000000000000000000011111111113
3111111111111100000000000000000011111111111111111100000000000000000000000011111111111111100000000000000000000000000000000001111111110000000000000000000011000000000000001111000000000111111111111113
3111111111111111001111100000000000000000000000000000000000000000000000000000000000000000000001111111111111100000000000000001111111110000000000000000111111111111111110000000001110001111111111111113
3111111000000000000000000111111111111111100000000000000000000001111111111111111111100000000000000000000000000000001111111111111111110000000011111111111111000000011111111111111111000000000000001113
3111111100000000000000000000000000000000000111111111111111111111111110000000000000000001111111111100000000000000000000000000001111111111111111111111111100000000000000111111000000100110000011111113
3111111111111111100000000000000000000001111111111111111111100000000000011111111111111111111111111111111000000000000000000000000000000000111111111111100000000000000000000000000000001111111111111113
3111111111111111111111111000000000000000011111111111111111111000111100000000000000000011111111111111111111111111111111111111110000000000000000000000000011111110000111111111111111111111111111111113
3111111111111111111111111000000000000000000000000000000000000000000000111111111111111111111111111111111111100000000000000000000000001111110001111111111111111111111111111111111111111111111111111113
3111111111111111111111111100000000000000000000000000000000000000000001111111111111111111111111111111111111111111111111111111111111111111111000000000000000000000000000111111111111111111111111111113
3111111111111111111111111111111111111111111110000000111111111000000111111111111111111111111111111111111111111111111111111111111111111111111111111111100000000000000000001111111111111111111111111113
3111111111111111111111111111111111111111111111111111111111111111111111111111111111111111111111111111111111111111111111111111111111111111111111111111111111111111111111111111111111111111111111111113