3000000000000000000000000000000000000000000000000000000000000000000000000000000000000000000000000000000000000000000000000000000000000000000000000000000000000000000111111111111111100000000000000000000000000000000000000000000000000000003
3000000000000000000000000000000000000000000000000000000000000000000000000000000000000000000000000000000000000000000000000000000000000000000000000000000000000000000111111111111111100000000000000000000000000000000000000000000000000000003
3000000000000000000000000000000000000000000000000000022222222220000000000000000000000000000000000000000000000000000000000000000000000000000000000000000000000000000111111111111111100000000000000000000000000000000000000000000000000000003
3000000000000000000000000000000000000000000000000000000000000000000000000000000000000000000000000000000000000000000000000000000000000000000000000000000000000000000111111111111111100000000000000000000000000000000000000000000000000000003
3000000000000000000000000000000000000000000000000000000000000000000000000022222222222222000000000000000000000002222222222200000000000000000000000000000000000000000111111111111111100000000000000000000000000000000000000000000000000000003
3000000000000000000000000000000000000000000000000022222222222222222200000001111111111111100000000000000000000000000000000000000000002222222222222000022222200000000111111111111111100000000000000000000000000000000000000000000000000000023
3000000000000000000000000000000000000000000000000211111111111111111120000000000000000000000000000000000000002211111100000000000000000000000000111000111100000000000111111111111111100000000000000000000000000000000222222000000000000000213
3000000000000000000000000000000000000000000000000000000000000000000000002222000000000000000000000022220000000000000002222222222222000000000000000000010000222200000111111111111111100000000000000002222222222222222111111000000000000002113
3000000000000000000000000000000022222200000000000000000000000000000000000000000000000000022222000000000000000000000000000011111111022222222000000000000000011100000111111111111111100000000000000001111111111111111111111000000000000021113
3000000000000000000000000000002211111122202220222222222220000000000000000000000111111111111000000000000000000000000222211110000000000000000000000000000000000000000000000000000000000000022222220000111111111111111111111100000000000211113
3000000000000000000000000022200111111111100000011111111110000000000000000000000000000000000000000000000000000000000000000000000000000000000222000000000000000000000222222222222222220000111111100000000000000000000000000000000000002111113
3000000000000000200220022000000000000000000000011111111110000000000000000000000000000001111111111111111111100000000000000000002220022000000000000000000000022002202111111111111111112200000000000000000000000000000000000000000000021111113
3222222222222000211111111111111111111111111111111111111111100000000000000000000000000000000000000000000000000000000000000002200000000111111111111111111111000000000000011111111111111111111110000000011111111111111111111111111111111111113
3111111111100212122112212212222111111111122222211111111111111111111110000000000000001111111111111110000011111111111111111111110000000111111111111111111111111110000111111111111111111111111111111111111111111111111111111111111111111111113
3111111000002111111111111111111111111111111111111111111111111111111111111111111111111111111111111111111111111111111111111111111000000000000011111111111111111111100001111100000000000000000000001111111111111111111111111111111111100000113
3111111001121111111111111111111111111111111111111111111111111111111111111111111111111111111111111111111111111111111111111111111100000000000111111111111111111111111000000000000000000000000000001111111111111111111111111110000000000000113
3111111111111111111111111111111111111111111111111111111111111111111111111111111111111111111111111111111111111111111111111111111110000000001111111111111111111111111100000000000000000000000000011111111111111111111000000000000000000000113
3111111111111111111111111111111111111111111111111111111111111111111111111111111111111111111111111111111111111111111111111111111111000000011111111111111111111111111111111111111111111111111111111111111111111110000000000000000000000000113
3111111111111111111111111111111111111111111111111111111111111111111111111111111111111111111111111111111111111111111111111111111111111111111111111111111111111111111111111111111111111111111111111111111111111111111111111111111111111111113
3111111111111111111111111111111111111111111111111111111111111111111111111111111111111111111111111111111111111111111111111111111111111111111111111111111111111111111111111111111111111111111111111111111111111111111111111111111111111111113